11
11
11111111121
10000000001
10111111111
10100000001
10101111101
10101000101
10101010101
10101010001
10101011111
10001000003
11111111111