15
15
111111111211111
100000000000003
101111111111111
101000000011001
101011111011011
101010101011011
101010101011011
101010000011011
101010111111011
100010000000001
111110110111111
100010110000001
101110110111101
100000110000111
111111111111111