10
10
1111311111
1000000001
1000000001
1000000001
1000000001
1000000001
1000000001
1000000001
1000000001
1111211111