15
15
111111111111111
100000000000001
101111111011101
101100001111101
101101000000101
101100111110101
101110010000101
101101001110101
100001100110101
111101010010001
101101011001111
100001011100111
101111000110011
100000010111001
111111113111121