18
18
121111111111111111
101000000000000011
101011110111111011
101010010100001011
101010110101101011
101010110101111011
101010000100000003
101011111111111111
101000000000000001
101111111111111101
100000000000000001
111111111111111101
100000000000000101
101111111111110101
101000000000000101
101111111111111101
100000000000000001
111111111111111111