16
30
111111111111111111111111111111
110101010101010101010101010101
100000000000000000000000000001
101111111111110111111111111111
101111111111110111111111111111
100000000000000000000000000001
101111111111111111111111111101
100000000000000000000000000001
101111111111110111111111111111
101111111111110111111111111111
100000000000000000000000000001
101111111111111111111111111101
100000000000000000000000000001
101111111111110111111111111111
100000000000110111111111111111
111111111113112111111111111111