11
11
11111111111
20100000103
10101110101
10101000101
10111010001
10100010111
10101010111
10101010001
10101011101
10001000001
11111111111