18
30
111111111111111111111111111131
100000000000000000000000011101
101111111111111111111111011101
101100000000000000011110011101
101111111011110111110000111101
101100001010110111110111000001
101101101010110000000110011111
101101101010111111111110110001
101101101010111101111110110101
101101101010000000000010110101
101101101010111101111110000101
101101111010101101111111111101
101100000010100000000000000001
101111111010111111111111111111
101000000000000000000000000001
101111111111111110111111111111
100000000000000010111111111111
111111111111111211111111111111